10 23 23 23 23 23 23 23 23 23 23 23 23 11 23 23 23 23 23 23 23 23 23 23 23 23 12
20  5  5  5  5  5  5  5  5  5  5  5  5 20  5  5  5  5  5  5  5  5  5  5  5  5 20
20  5  1  2  2  3  5  1  2  2  2  3  5 20  5  1  2  2  2  3  5  1  2  2  3  5 20
20  5  4  5  5  6  5  4  5  5  5  6  5 20  5  4  5  5  5  6  5  4  5  5  6  5 20
20  5  7  8  8  9  5  7  8  8  8  9  5 21  5  7  8  8  8  9  5  7  8  8  9  5 20
20  5  5  5  5  5  5  5  5  5  5  5  5  5  5  5  5  5  5  5  5  5  5  5  5  5 20
20  5 22 23 23 24  5 19  5 22 23 23 23 11 23 23 23 24  5 19  5 22 23 23 24  5 20
20  5  5  5  5  5  5 20  5  5  5  5  5 20  5  5  5  5  5 20  5  5  5  5  5  5 20
16 23 23 23 23 12  5 13 23 23 23 24  5 21  5 22 23 23 23 15  5 10 23 23 23 23 18
 5  5  5  5  5 20  5 20  5  5  5  5  5  5  5  5  5  5  5 20  5 20  5  5  5  5  5
23 23 23 23 23 18  5 21  5  1  2  2  2  5  2  2  2  3  5 21  5 16 23 23 23 23 23
 5  5  5  5  5  5  5  5  5  4  5  5  5  5  5  5  5  6  5  5  5  5  5  5  5  5  5
23 23 23 23 23 12  5 19  5  7  8  8  8  8  8  8  8  9  5 19  5 10 23 23 23 23 23
 5  5  5  5  5 20  5 20  5  5  5  5  5  5  5  5  5  5  5 20  5 20  5  5  5  5  5
10 23 23 23 23 18  5 21  5 22 23 23 23 11 23 23 23 24  5 21  5 16 23 23 23 23 12
20  5  5  5  5  5  5  5  5  5  5  5  5 20  5  5  5  5  5  5  5  5  5  5  5  5 20
20  5 22 23 23 12  5 22 23 23 23 24  5 21  5 22 23 23 23 24  5 10 23 23 24  5 20
20  5  5  5  5 20  5  5  5  5  5  5  5  5  5  5  5  5  5  5  5 20  5  5  5  5 20
13 23 23 24  5 21  5 19  5 22 23 23 23 11 23 23 23 24  5 19  5 21  5 22 23 23 15
20  5  5  5  5  5  5 20  5  5  5  5  5 20  5  5  5  5  5 20  5  5  5  5  5  5 20
20  5 22 23 23 23 23 17 23 23 23 24  5 21  5 22 23 23 23 17 23 23 23 23 24  5 20
20  5  5  5  5  5  5  5  5  5  5  5  5  5  5  5  5  5  5  5  5  5  5  5  5  5 20
16 23 23 23 23 23 23 23 23 23 23 23 23 23 23 23 23 23 23 23 23 23 23 23 23 23 18
